黃連	Isoquinoline alkaloids:Berberine
黃柏	Isoquinoline alkaloids:Berberine
苦參	生物鹼：Matrine (苦參鹼)/ 黃酮類
石斛	倍半萜類生物鹼：Dendrobine (石斛鹼) 高溫下不穩定、宜生用
附子	雙萜類生物鹼：Aconitine 烏頭鹼
吳茱萸	Indole 類生物鹼：Evodiamine,Rutaecarpine
貝母	Steroidal 類生物鹼、如Verticine(Peimine)
延胡素	生物鹼：protopine, 其中具有 isoquinoline 結構 / d-tetrahydropalmatine
益母草	生物鹼：Leonurine
鉤藤	主要含 indole 類生物鹼，如rhynchophylline (鉤藤鹼)
阿膠	多由 Gelatin(明膠)、Colleagen(膠原蛋白)及其部分水解產物產物所組成
龜板	蛋白質：Collagen / 多種氨基酸

葛根	Isoflavonoid:指標成分包括大豆苷元（Daidzein)大豆苷（Daizin)葛根素（Puerarin)
柴胡	-皂苷：柴胡皂苷（SaikosaponinA-G) -柴胡醇（Bupleurumol) -豆固醇（Stigmasterol)
知母	-固醇類皂苷：知母皂苷（Timosaponin)
梔子	-單萜類配醣體：Geniposide -Crocin
夏枯草	三萜類：Ursolic acid
黃芩	類黃酮（flavonoid):主要成分黃芩苷元（baicalein)
龍膽	單萜類配醣體：Secoiridoid 2%•Gentiopicrin
地黃	Iridoid glycosides
牡丹皮	-Paeonolide -Glycoside類：存在於新鮮根皮中，包括Paeonol
敗醬草	Flavonones類
板藍根	-靛苷（indican) -靛玉紅（indirubin)
木通	含有以Hederagenin及Oleanolic acid 為皂基的Saponin:Akiboside st b-f,h,k
五加皮	配醣體類：丁香苷（syringin),刺五加（Eleutheroside A)
白芷	-Coumarin -Furocoumarins
枇杷葉	枇杷苷 A(Eriijaposide A)
桔梗	皂苷：PlatycodinA-H,以Platycodin D最主要
紅花	Glycoside類：Safflor yellow A,B—>黃色素
黨參	苯丙烷苷類：當參苷（Tangshenoside I-IV),Syringin
何首烏	Anthraquinone類、包含Chrysophanol,Emodin
續斷	單萜類苷類（Iridoid glycoside):Cantleyoside -生物鹼：Cantleyine -肉蓯鹼	Phenylethanoid glycosides -Iridoid lignan,Acteoside
鎖陽	三萜類：熊果酸（Ursolic acid) -植物固醇：beta-Sitosterol,Daucosterol
麥門冬	皂苷：OphiopogoninA-D -Flavonoids類：Ophiopogonanone
女貞子	Iridoid glycosides: Ligustroside
蒺藜	類黃酮苷：Tribuloside -生物鹼：Harmine(有毒）
山茱萸	Iridoid glycosides -Tannins 類：Gallic acid
酸棗仁	triterpenoids:Betullin,Jujuboside A,B
遠志	皂苷類：OnjisaponinA-G,TenuifolinA,B
天麻	酚類化合物及其苷類Gastrodun,Gastrodioside
白芍	單萜苷類：為白芍的有效成分、包含Paeoniflorin
赤芍	單萜苷類：為赤芍的有效成分，包含：Lactiflorin

車前子	親水性膠體（hydrocolloids)
大黃	Rhein,Chrysophanol -Tannins
杏仁	雙醣苷：Amygdalin
人參	Triterpenoid saponins:Ginsenosides,panaxosides,Chikusetsusaponins
甘草	Glycyrrhizin -Glycyrrhetic acid
薄荷	L-menthol(左旋性）
青蒿	倍半萜內脂環衍生物：Artemisinin -活性部分結構為endoperoxude環
薑	三香二辣 -Zinginerol,Zingiberene,Bisabolene(三香）-芳香酮類：Zingerone,Shogaol(二辣）
小茴香	酚醚類揮發油：E-Anethole
丁香	Flavonoid配糖體：芸香苷（Rutin)
桂皮	醛類揮發油Cinnamaldehyde
麻黃	Alkaloidal生物鹼：（-）-erythro-ephedrine

胖大海	西黃耆膠黏素Bassorin
栝蔞根	天花粉蛋白Trichosanthin
白芨	黏液質：白芨葡萄甘露聚糖 -Bletilla Glucomannan
牛膝	黏液質、皂素水解後會產生齊墩果酸（Oleanolic acid)
大棗	D-fructose
枸杞子	生物鹼：甜菜鹼（Betaine)
地骨皮	生物鹼：甜菜鹼（Betaine)
黃精	多醣類：黃精多醣
冬蟲夏草	多醣體：中性甘露糖基葡萄聚糖（Mannoglucan)
紫草	Naphthoquinone類、Shikonin紫草素
連翹	Lignans:Arctigenin（主要）-Glycosides:Arctin
厚朴	生物鹼：Magnocurarine -Lignans:Magnolol
蘇木	Brasilin:黃色，其氧化後變成紅褐色的Brasilein
當歸	揮發油類：以Ligustilide及Butylidene phthalide爲主
杜仲	Ligninoglycosides:Pinoresinol diglucoside->爲杜仲降血壓活性成分
補胎脂	Coumarins:Psorien及Angelicin
淫羊藿	類黃酮（Flavonoids):Icariin(淫羊藿苷）
五味子	Lignans:Schizandrin,Gomisins
訶子	主要含Tannins,賦予訶子收歛作用
蛇床子	Coumarins:Osthol 多種揮發油

紫蘇	Monoterpenoids:紫蘇醛perillaldehyde
防風	油脂及揮發油：-coumarins -Chromones:Hamaudol
荊芥	單萜類：d-menthone(右旋薄荷酮）
辛夷	-揮發油：Cineole,alpha-Pinene -Lignans,Magnolin
金銀花	Monoterpenoids:Pinene Linalool
蒲公英	三萜成分：蒲公英固醇Taraxasterol
細辛	-木脂素（Lignan):l-Asarinin -揮發油：Methyleugenol -辛味成分：Pellitorine
蒼朮	揮發油：Atractylol,Hinesol,beta-Eudesmol
茯苓	聚醣：beta-Pachymaran
澤瀉	Protostane type 三萜類：Alisol A-C,O,P(澤瀉醇） Guaiane型肝炎倍半萜類
半夏	-生物鹼：L-Ephedrine -蛋白質：半夏蛋白（Pinellin)
桑白皮	三萜類：alpha-amyrin(alpha-香樹脂醇）、Betulinic acid(白樺脂酸）
沉香	揮發油：Benzylactetone,p-methoxybenzylacetone
薑黃	揮發油：alpha-Turmerone,Zingiberene,Sabinene Curcumin(薑黃素）
陳皮	揮發油：d-Limonene -類黃酮：Hesperidin,Neohesperidin,Naringin
艾葉	Artemisia argyi
川芎	Phthalide(苯酞）：Cnidilide,Neocnidilide,Ligustillide,Senkynolide
丹參	雙萜類：Tanshinone(丹參酮）、Cryptotanshinone -苯丙烷類
黃耆	多醣體：Astragalan I-III -三萜類：Cycloartane
白朮	倍半萜類（sesquiterpenes)：蒼朮酮（Atractylon)最多
覆盆子	Labdane型二萜苷：GoshonosideF1-F7
升麻	Phenylpropanoids:Isoferulic acid,Ferulic acid,Caffeic acid -三萜類：Cimigenol
