人參	[Dammarane 皂苷] Ginsenosides
西洋參	[Dammarane 皂苷] Ginsenosides
黨參	[苯丙烷苷] Tangshenoside
黃耆	[Cycloartane 三萜] Astragalosides
山藥	[多醣] Dioscorans / [固醇類] Diosgenin
大棗	[單糖] Fructose (major) / [皂苷] Jujuboside B / [Flavone C-配糖體] Acylspinosins / [其他] Spinosin
甘草	[三萜皂苷] Glycyrrhizin
當歸	[Phthalide 內酯] Ligustilide, Butylidene phthalide / [類苯丙烷] Ferulic Acid 阿魏酸
地黃	[Iridoid 配糖體] Catalpol 梓醇, Rehmanniosides D 地黃苷 / [單糖] Stachyose 水蘇糖
白芍	[單萜苷] Paeoniflorin 芍藥苷, Albiflorin 白芍苷
何首烏	[Anthraquinone] Chrysophanol 大黃酚, Emodin 大黃素 / [Stilbene] Resveratrol 白藜蘆醇

阿膠	多由 Gelatin 明膠、Colleagen 膠原蛋白及其部分水解產物產物所組成

枸杞子	[生物鹼] 甜菜鹼 (Betaine)
麥門冬	皂苷：Ophiopogonin A-D / Flavonoids 類：Ophiopogonanone
知母	[固醇類皂苷]知母皂苷 (Timosaponin)
石斛	倍半萜類生物鹼：Dendrobine (石斛鹼) 高溫下不穩定、宜生用
女貞子	Iridoid glycosides: Ligustroside
黃精	多醣類：黃精多醣
龜板	蛋白質：Collagen / 多種氨基酸	

肉蓯蓉	 (Ｘ) 
淫羊藿	類黃酮 (Flavonoids):Icariin (淫羊藿苷) 
蒺藜	類黃酮苷：Tribuloside -生物鹼：Harmine (有毒) 
杜仲	Ligninoglycosides:Pinoresinol diglucoside->爲杜仲降血壓活性成分
鎖陽	三萜類：熊果酸 (Ursolic acid) -植物固醇：beta-Sitosterol,Daucosterol
續斷	單萜類苷類 (Iridoid glycoside):Cantleyoside -生物鹼：Cantleyine -肉蓯鹼	Phenylethanoid glycosides -Iridoid lignan,Acteoside
補骨脂	Coumarins:Psorien及Angelicin
冬蟲夏草	多醣體：中性甘露糖基葡萄聚糖 (Mannoglucan)
	
附子	雙萜類生物鹼：Aconitine 烏頭鹼
肉桂	醛類揮發油Cinnamaldehyde
吳茱萸	Indole 類生物鹼：Evodiamine,Rutaecarpine
小茴香	酚醚類[揮發油]E-Anethole
細辛	-木脂素 (Lignan):l-Asarinin -[揮發油]Methyleugenol -辛味成分：Pellitorine
丁香	Flavonoid配糖體：芸香苷 (Rutin)	
炮薑	 (Ｘ) 

沉香	[揮發油]Benzylactetone,p-methoxybenzylacetone
陳皮	[揮發油]d-Limonene -類黃酮：Hesperidin,Neohesperidin,Naringin

鉤藤	主要含 indole 類生物鹼，如rhynchophylline (鉤藤鹼)
天麻	酚類化合物及其苷類Gastrodun,Gastrodioside	

酸棗仁	triterpenoids:Betullin,Jujuboside A,B
遠志	皂苷類：OnjisaponinA-G,TenuifolinA,B	

五味子	Lignans:Schizandrin,Gomisins
山茱萸	Iridoid glycosides -Tannins 類：Gallic acid
訶子	主要含Tannins,賦予訶子收歛作用
覆盆子	Labdane型二萜苷：GoshonosideF1-F7

麻黃	Alkaloidal生物鹼：(-)-erythro-ephedrine
辛夷	-[揮發油]Cineole,alpha-Pinene -Lignans,Magnolin
白芷	-Coumarin -Furocoumarins
蒼耳子
防風	油脂及[揮發油]-coumarins -Chromones:Hamaudol
紫蘇葉	Monoterpenoids:紫蘇醛perillaldehyde
荊芥	單萜類：d-menthone(右旋薄荷酮) 
生薑	三香二辣 -Zinginerol,Zingiberene,Bisabolene(三香) -芳香酮類：Zingerone,Shogaol(二辣) 	

柴胡	-皂苷：柴胡皂苷 (SaikosaponinA-G) -柴胡醇 (Bupleurumol) -豆固醇 (Stigmasterol)
葛根	Isoflavonoid:指標成分包括大豆苷元 (Daidzein)大豆苷 (Daizin)葛根素 (Puerarin)
薄荷	L-menthol(左旋性) 
升麻	Phenylpropanoids:Isoferulic acid,Ferulic acid,Caffeic acid -三萜類：Cimigenol

半夏	-生物鹼：L-Ephedrine -蛋白質：半夏蛋白 (Pinellin)
貝母	Steroidal 類生物鹼、如Verticine(Peimine)
桔梗	皂苷：PlatycodinA-H,以Platycodin D最主要
胖大海	西黃耆膠黏素Bassorin

白果	 (Ｘ) 
杏仁	雙醣苷：Amygdalin
桑白皮	三萜類：alpha-amyrin(alpha-香樹脂醇) 、Betulinic acid(白樺脂酸) 
枇杷葉	枇杷苷 A(Eriijaposide A)

茯苓	聚醣：beta-Pachymaran
白朮	倍半萜類 (sesquiterpenes)：蒼朮酮 (Atractylon)最多
車前子	親水性膠體 (hydrocolloids)
木通	含有以Hederagenin及Oleanolic acid 為皂基的Saponin:Akiboside st b-f,h,k
澤瀉	Protostane type 三萜類：Alisol A-C,O,P(澤瀉醇)  Guaiane型肝炎倍半萜類	

蒼朮	[揮發油]Atractylol,Hinesol,beta-Eudesmol
厚朴	生物鹼：Magnocurarine -Lignans:Magnolol

五加皮	配醣體類：丁香苷 (syringin),刺五加 (Eleutheroside A)

大黃	Rhein,Chrysophanol -Tannins
蘆薈	 (Ｘ) 

丹參	雙萜類：Tanshinone(丹參酮) 、Cryptotanshinone -苯丙烷類
桃仁	 (Ｘ) 
紅花	Glycoside類：Safflor yellow A,B—>黃色素
延胡索	生物鹼：protopine, 其中具有 isoquinoline 結構 / d-tetrahydropalmatine
蘇木	Brasilin:黃色，其氧化後變成紅褐色的Brasilein
川芎	Phthalide(苯酞) ：Cnidilide,Neocnidilide,Ligustillide,Senkynolide
薑黃	[揮發油]alpha-Turmerone,Zingiberene,Sabinene Curcumin(薑黃素) 
益母草	生物鹼：Leonurine
牛膝	黏液質、皂素水解後會產生齊墩果酸 (Oleanolic acid)
乳香　 (Ｘ) 

白及	黏液質：白芨葡萄甘露聚糖 -Bletilla Glucomannan
艾葉	Artemisia argyi
槐花	 (Ｘ) 
三七	 (Ｘ) 

金銀花	Monoterpenoids:Pinene Linalool
連翹	Lignans:Arctigenin (主要) -Glycosides:Arctin
蒲公英	三萜成分：蒲公英固醇Taraxasterol
北板藍根	-靛苷 (indican) -靛玉紅 (indirubin)
敗醬草	Flavonones類

梔子	-單萜類配醣體：Geniposide -Crocin
夏枯草	三萜類：Ursolic acid
栝蔞根	天花粉蛋白Trichosanthin

黃連	Isoquinoline alkaloids:Berberine
黃芩	類黃酮 (flavonoid):主要成分黃芩苷元 (baicalein)
黃柏	Isoquinoline alkaloids:Berberine
龍膽	單萜類配醣體：Secoiridoid 2%•Gentiopicrin
苦參	生物鹼：Matrine (苦參鹼)/ 黃酮類

牡丹皮	-Paeonolide -Glycoside類：存在於新鮮根皮中，包括Paeonol
紫草	Naphthoquinone類、Shikonin紫草素
赤芍	單萜苷類：為赤芍的有效成分，包含：Lactiflorin

地骨皮	生物鹼：甜菜鹼 (Betaine)
青蒿	倍半萜內脂環衍生物：Artemisinin -活性部分結構為endoperoxude環

蛇床子	Coumarins:Osthol 多種揮發油

檳榔	